################################################################################
#..............................................................................#
#..............................................................................#
#..............................................................................#
#..............................................................................#
#..............................................................................#
#..............................................................................#
#..............................................................................#
#..............................................................................#
#..............................................................................#
#..............................................................................#
#..............................................................................#
#..............................................................................#
#..............................................................................#
#..............................................................................#
#..............................................................................#
#.......P......................................................................#
#..............................................................................#
############............................................########################
#..........#............................................#......................#
#..........#............................................#......................#
#..........#............................................#......................#
#..........#.............SSSSSSSSSSSSSSSSSSSSSSSSSSSSSSS#......................#
################################################################################
eol
spawn 8,14
fin 74,14
horizontal
hlength 80
hpos 0,0
eoh
horizontal
hlength 80
hpos 0,23
eoh
vertical
vlength 22
vpos 0,1
eov
vertical
vlength 22
vpos 79,1
eov
horizontal
hlength 14
hpos 1,17
eoh
horizontal
hlength 14
hpos 67,17
eoh
vertical
vlength 5
vpos 67,18
eov
horizontal
hlength 8
hpos 36,17
eoh
vertical
vlength 5
vpos 14,18
eov
spike
sdir 0
spos 15,22
eos
spike
sdir 0
spos 17,22
eos
spike
sdir 0
spos 19,22
eos
spike
sdir 0
spos 21,22
eos
spike
sdir 0
spos 23,22
eos
spike
sdir 0
spos 25,22
eos
spike
sdir 0
spos 27,22
eos
spike
sdir 0
spos 29,22
eos
spike
sdir 0
spos 31,22
eos
spike
sdir 0
spos 33,22
eos
spike
sdir 0
spos 35,22
eos
spike
sdir 0
spos 37,22
eos
spike
sdir 0
spos 39,22
eos
spike
sdir 0
spos 41,22
eos
spike
sdir 0
spos 43,22
eos
spike
sdir 0
spos 45,22
eos
spike
sdir 0
spos 47,22
eos
spike
sdir 0
spos 49,22
eos
spike
sdir 0
spos 51,22
eos
spike
sdir 0
spos 53,22
eos
spike
sdir 0
spos 55,22
eos
spike
sdir 0
spos 57,22
eos
spike
sdir 0
spos 59,22
eos
spike
sdir 0
spos 61,22
eos
spike
sdir 0
spos 63,22
eos
spike
sdir 0
spos 65,22
eos
eof