frames 10
width 50
height 20
color white
##################################################
#................................................#
#................................................#
#................................................#
####################......................########
#.........................................########
#.........................................########
#........................#######..........########
#.........................#####...........########
#...........................#....................#
#................................................#
#................................................#
#####################............................#
#...................#............................#
#...................#............................#
#...................#............................#
#...................#............................#
#...................#............................#
#...................#............................#
##################################################
end
##################################################
#................................................#
#................................................#
#................................................#
#....###################..................########
#.........................................########
#.........................................########
#........................#######..........########
#.........................#####...........########
#...........................#....................#
#................................................#
#................................................#
#####################............................#
#...................#............................#
#...................#............................#
#...................#............................#
#...................#............................#
#...................#............................#
#...................#............................#
##################################################
end
##################################################
#................................................#
#................................................#
#................................................#
#........###################..............########
#.........................................########
#.........................................########
#........................#######..........########
#.........................#####...........########
#...........................#....................#
#................................................#
#................................................#
#####################............................#
#...................#............................#
#...................#............................#
#...................#............................#
#...................#............................#
#...................#............................#
#...................#............................#
##################################################
end
##################################################
#................................................#
#................................................#
#................................................#
#.............###################.........########
#.........................................########
#.........................................########
#........................#######..........########
#.........................#####...........########
#...........................#....................#
#................................................#
#................................................#
#####################............................#
#...................#............................#
#...................#............................#
#...................#............................#
#...................#............................#
#...................#............................#
#...................#............................#
##################################################
end
##################################################
#................................................#
#................................................#
#................................................#
#...................###################...########
#.........................................########
#.........................................########
#........................#######..........########
#.........................#####...........########
#...........................#....................#
#................................................#
#................................................#
#####################............................#
#...................#............................#
#...................#............................#
#...................#............................#
#...................#............................#
#...................#............................#
#...................#............................#
##################################################
end
##################################################
#................................................#
#................................................#
#................................................#
#......................###########################
#.........................................########
#.........................................########
#........................#######..........########
#.........................#####...........########
#...........................#....................#
#................................................#
#................................................#
#####################............................#
#...................#............................#
#...................#............................#
#...................#............................#
#...................#............................#
#...................#............................#
#...................#............................#
##################################################
end
##################################################
#................................................#
#................................................#
#................................................#
#...................###################...########
#.........................................########
#.........................................########
#........................#######..........########
#.........................#####...........########
#...........................#....................#
#................................................#
#................................................#
#####################............................#
#...................#............................#
#...................#............................#
#...................#............................#
#...................#............................#
#...................#............................#
#...................#............................#
##################################################
end
##################################################
#................................................#
#................................................#
#................................................#
#.............###################.........########
#.........................................########
#.........................................########
#........................#######..........########
#.........................#####...........########
#...........................#....................#
#................................................#
#................................................#
#####################............................#
#...................#............................#
#...................#............................#
#...................#............................#
#...................#............................#
#...................#............................#
#...................#............................#
##################################################
end
##################################################
#................................................#
#................................................#
#................................................#
#........###################..............########
#.........................................########
#.........................................########
#........................#######..........########
#.........................#####...........########
#...........................#....................#
#................................................#
#................................................#
#####################............................#
#...................#............................#
#...................#............................#
#...................#............................#
#...................#............................#
#...................#............................#
#...................#............................#
##################################################
end
##################################################
#................................................#
#................................................#
#................................................#
#....###################..................########
#.........................................########
#.........................................########
#........................#######..........########
#.........................#####...........########
#...........................#....................#
#................................................#
#................................................#
#####################............................#
#...................#............................#
#...................#............................#
#...................#............................#
#...................#............................#
#...................#............................#
#...................#............................#
##################################################
end
eof
slow 10
spawn 4,10
fin 10,4
button 
bpos 6,4
btime 5
btrig 11,6
btrig 11,7
btrig 11,8
btrig 5,8
eob
eol