################################################################################
#..............................................................................#
#..............................................................................#
#..............................................................................#
####################......................#######..............................#
#.........................................#######..............................#
#.........................................#######..............................#
#........................#######..........#######..............................#
#.........................#####...........#######..............................#
#...........................#..................................................#
#..............................................................................#
#..............................................................................#
#####################..........................................................#
#...................#..........................................................#
#...................#..........................................................#
#...................#..........................................................#
#...................#..........................................................#
#...................#..........................................................#
#...................#..........................................................#
#...................#..........................................................#
#...................#..........................................................#
#...................#..........................................................#
#...................#..........................................................#
################################################################################
eol
spawn 60,22
fin 10,4
button
bpos 8,3
btime 5
btrigs 4
btrig 11,6
btrig 11,7
btrig 11,8
btrig 5,8
eob
spike
spos 10,15
eos
eof